NO ./texture/walln.png
SO ./texture/walls.png
WE ./texture/wallw.png
EA ./texture/walle.png

F 220,100,0
C 225,30,0

111111111111111111111111111111111111111111111111111111111111
100000000000000000000000000000000000000000000000000000000001
100100100111100100000100000011000000000000000000000000000001
100100100100000100000100000100100000000000000000000000000001
100111100110000100000100000100100000000000000000000N00000001
100100100100000100000100000100100000000000000000000000000001
100100100111100111100111100011000000000000000000000000000001
100000000000000000000000000000000000000000000000000000000001
100000000000000000000000000000000000000000000000000000000001
100111100100010011110010000010010011110011111000110001111001
100100000100010010010010000010010010010000100001001001001001
100110000010100011110010000010010011110000100001001001110001
100100000010100010010010000010010010010000100001001001010001
100111100001000010010011110001100010010000100000110001001001
100000000000000000000000000000000000000000000000000000000001
100000000000000000000000000000000000000000000000000000000001
111111111111111111111111111111111111111111111111111111111111

