NO ./texture/walln.png
SO ./texture/walls.png
WE ./texture/wallw.png
EA ./texture/walle.png

F 168,86,50
C 57,170,227




1111111111111111111111
1001001001001001001001
1000000000000000000001
1001001001001001001001
1001111111001111111111
1000001000001000000011
1111001000000000010001
1000001000001000010001
1001001000000000010001
100000000000100N011101
1000000000000000000001
1111111111111111111111

