





11111111111111
100000000   00001
10011111110001
100    00010000001   
10000010000001
10000010000    001
10000010000001
10000000000011
100N0000S00111
11111111111111