11111111111111
1000000000    0001
10011111110001
100    00010000001   
10000010000001
10000010000001
10000010000001
10000000N    00111
100     00000000001
11111111111111