NO ./texture/walln.png
SO ./texture/walls.png
WE ./texture/wallw.png
EA ./texture/walle.png

F 220,100,0
C 225,30,0

11111111111111
100000000   000S1
10011111110001
100    00010000001   
10000010000001
10000010000    001
10000010000001
10000000000011
10000000000111
11111111111111



