11111111111111
10000000000001
10011111110001
10000010000001
10000010000001
10000010000001
10000010000001
10000000N00111
10000000000001
11111111111111