01111111111
00000000001
01000000001
11111111111
00000000001
11111111111
00000000001
00000001101
11111111111
00000000001