1111111
1000001
1000001
1000N011
1111111